   XXX    XXXXXXX
 X XXXXXXXXXXXXXX
 X X XXXXXXX XXXX
 X X XXXXXXX XXXX
 X X XXXXXXX XXXX
 X       XXX XXXX
   XXXX      XXXX
