P  XXX    XXXXXXX
 X             XX
 X X XXXXXXX    E
 X X XXXXXXX XXXX
 X X XXXXXXX XXXX
 X       XXX XXXX
   XXXX      XXXX
