X XXXX    XXXXXXXX
  X    XX    X   P
 XX XXXXXXXX X XXX
 X       X   X    
 X XXX X X XXX XX 
 X   X X X     XX 
 X X     X XXXXXX 
 X XXXX XX XXEXXX 
 X       X XX     
 XXXXXXX   XXXXXXX
           XXXXXXX